1111111111111111111111111111111111
100000000G0000C0000000000000000001
1010C10100100000101001000000010101
1010010010101010001001000000010101
100000C000000000000000000000000001
1000000000000000000K00C00000000001
1000000000100000E0000000C000010001
1000000000010000P00C00000010000001
1000000000001000000000000100000001
1000000000000000000000000100000001
100000000000000000G000000000000001
1P0000C000000000000010000100000001
1111111111111111111111111111111111
