11111111111111111111
1CCCC0000CCCC0000001
1CCCC0G00CCCC0G00001
1CCCC0G00CCCC0G00001
1CCCC0000CCCC0000001
10000CCCC0000CCCC001
10000CCCC0000CCCC001
10000CCCC0000CCCC001
10000CCCC0000CCCC001
10000000000000000001
10000000000000000001
10000000000000000001
10000G0000G000000001
10000G0000G000000001
10000G0000G000000PE1
11111111111111111111
